NO ./path_to_the_north_texture     ghhg
SO ./path_to_the_south_texture
WE  ./path_to_the_west_texture
       EA  ./path_to_the_east_texture

F 220    ,100,0
C 225,30,0



                        
 111111111111111111111111111 
11110000000000000000000010001
11110111111111011101010000101
11000000110101011100000010101
10011111100000001100000101101
10000000000000000001000010101
11N00001110101001111000000101
11111001111011101111111111111
11100000001111101111000001111
11100000001111100000000001111
11100000001111101111000001111
11100000000000000000000000001
 111111111111111111111111111
