NO ./path_to_the_north_texture     ghhg
SO ./path_to_the_south_texture
WE  ./path_to_the_west_texture
       EA  ./path_to_the_east_texture

F 220    ,100,0
C 225,30,0





                           
        11111111111111111111111
        100000000011000000000001
        1011000001110000100010001
        1001000000000001000010001
111111111011000001110000000000001
1000000000110000011101111000011111
11110111111111011100000010000000001
11110111111111011101010010000000001
11000000110101011100000010000000001
10000000000000001100000010000100001
10000000000000001101010010000N10001
1100000111010101111101111000000000111
11110111 1110101 101111010001111111
11111111 1111111 111111111111