NO ./path_to_the_north_texture     ghhg
SO ./path_to_the_south_texture
WE  ./path_to_the_west_texture
       EA  ./path_to_the_east_texture

F 220    ,100,0
C 225,30,0




11111111111111111111111111111
11110111111111011100000010001
10011111111111111111111111111
10010000000000000000000010001
11110111111111011101010000101
11000000110101011100000010101
10011111100000001100000101101
10000000000000000001000010101
11000001110101011111000000101
11100001111111000111111111111
11000001110101001111000000101
11111001111011101111111111111
11100000001001101111000001111
11100000001001100000000001111
11100000001S01101111000W01111
11100000000000000000000000001
 111111111111111111111111111