NO ./path_to_the_north_texture     ghhg
SO ./path_to_the_south_texture
WE  ./path_to_the_west_texture
       EA  ./path_to_the_east_texture

F 220    ,100,0
C 225,30,0






        111111111111111111111111 
        100000000011000000000001
        101100000111111110001111111111111111111111111
        10010000000000W10110000000000000000000000111
11111111101100000111111000000111111111111111111111111111
1000000000110000011101000000011111
11110111111111011100000010001
11110111111111011101010010001
11000000110101011100000010001
10000000000000001100000010001
10000000000000001101010010001
1100000111010101111101111000111
11110111 1110101 101111010001
11111111 1111111 111111111111
