NO ./mandatory/images/textures/north3.png
SO ./mandatory/images/textures/so1.png
WE ./mandatory/images/textures/so2.png
EA ./mandatory/images/textures/we1.png
F 95, 89, 108
C 0, 214, 194




111111111111111111111111111111111111
111101111111110111000000100000000001
100111111111111111111111111000000011
100100000000000000000000100000000001
100100000000000000000000100000000001
111101111111110111010100001000000001
110000001101010111000000101000000001
110000001101010111000000101000000001
100111111000000011000001011000000001
100000000000000000010000101000000001
100000000000000000010000101000000001
110000011101010111110000001000000001
111000011111110001111111111000000011
110000011101010011110000001000000001
111110011110111011111111111000000011
111000000010011011110000011000000011
111000000010011000000000011000000011
11100000001D111011110000011000000011
11100100000000000000000000000000011
111001D1000000000000000000000000111
1110010000000000000000000000000000T1
11100000000N00000000000000000000001
111111111111111111111111111111111111
